"values.mood1","values.mood2","values.mood3","values.mood4","values.mood5","values.mood6","values.mood7","values.mood8","values.mood9","values.mood10","values.mood11","values.mood12","values.mood13","values.mood14","values.mood15","values.mood16"
"22","19","36","16","20","40","17","17","31","26","17","12","21","16","1","12"
"38","40","44","27","40","35","38","40","44","24","43","42","25","32","43","40"
"46","26","27","34","34","60","14","30","37","15","65","33","25","19","73","21"
"54","38","11","23","56","38","39","13","39","25","44","15","4","38","39","23"
"16","17","37","19","26","20","21","25","24","29","17","27","29","19","24","21"
"49","11","58","68","60","66","20","1","37","1","77","48","29","1","56","26"
"59","7","13","50","49","52","11","30","52","3","52","39","5","32","42","9"
"58","35","44","57","54","56","39","37","55","40","55","41","31","26","73","38"
"45","57","58","46","42","57","47","48","56","46","42","53","45","46","56","46"
"35","38","60","31","30","67","55","56","33","56","21","43","47","45","57","54"
"67","33","56","65","63","66","22","39","33","58","46","26","47","31","15","26"
"56","46","58","44","58","58","46","46","62","45","55","49","41","46","86","60"
"29","18","64","33","63","27","2","27","45","32","66","26","21","22","33","51"
"58","47","50","53","50","52","48","44","53","47","54","44","37","46","53","48"
"41","23","37","41","38","62","25","26","57","28","57","30","27","27","33","63"
"60","28","45","59","59","69","27","26","55","27","62","43","42","40","70","43"
"50","49","48","50","49","57","46","50","49","45","50","47","49","46","88","53"
"47","43","60","52","48","57","54","53","52","44","55","54","56","55","59","53"
"33","26","36","47","44","39","22","15","40","29","35","41","19","23","28","40"
"79","20","58","68","29","83","27","60","67","23","72","61","46","36","80","68"
"58","38","45","43","45","63","39","47","56","47","57","37","38","41","52","49"
"91","33","65","68","32","73","29","34","66","30","68","60","29","5","67","63"
"42","33","50","43","46","45","44","46","42","42","43","45","48","45","65","46"
"43","42","30","43","39","65","41","12","36","46","36","14","28","35","33","39"
"57","16","50","56","33","58","22","31","54","17","55","44","48","11","22","20"
"57","35","60","54","31","55","39","21","31","33","35","31","35","23","57","41"
"54","1","20","29","15","84","1","1","72","1","60","23","5","1","31","9"
"72","36","76","81","77","80","84","60","76","66","66","68","71","68","80","76"
"57","16","45","57","56","65","55","44","59","28","57","65","46","28","97","59"
"83","8","76","84","84","98","35","13","86","16","88","53","25","23","72","68"
"24","28","31","29","45","33","34","62","34","25","26","27","31","13","33","57"
"40","43","39","38","45","41","45","44","43","44","44","43","37","34","43","35"
"60","36","57","55","48","72","27","26","60","49","62","39","33","56","35","54"
"44","15","38","28","25","44","26","16","33","11","33","34","29","22","55","44"
"39","41","57","55","62","61","47","36","61","27","49","62","49","72","57","60"
"61","29","32","35","63","32","29","32","36","27","57","32","27","33","67","41"
"79","41","59","59","41","83","42","39","67","39","63","57","42","47","62","57"
"59","40","36","40","38","49","47","40","67","56","64","37","43","43","81","50"
"55","36","45","39","41","57","58","36","56","34","45","45","39","36","61","58"
"32","56","43","28","21","48","42","38","40","41","53","43","45","43","44","48"
"67","24","62","66","61","68","20","25","62","23","68","58","21","36","30","46"
"61","42","69","60","58","56","68","64","60","58","59","61","58","69","60","67"
"51","49","45","52","46","45","54","45","49","45","46","47","40","38","44","46"
"45","8","10","6","27","57","4","11","33","5","35","24","5","4","17","14"
"56","19","64","59","61","61","33","66","60","25","63","32","39","23","27","72"
"54","28","38","54","45","57","40","41","54","41","57","50","37","44","60","64"
"27","18","34","20","24","29","28","28","24","29","29","32","14","32","28","27"
"55","14","36","45","35","40","45","35","57","35","39","41","35","46","41","57"
"17","3","32","24","42","42","12","5","31","9","38","40","4","26","23","41"
"43","36","42","42","33","60","38","38","46","41","61","37","30","41","57","44"
"71","21","52","42","82","78","32","18","83","17","66","38","58","36","55","37"
"62","39","38","60","36","63","40","37","47","38","65","40","35","39","58","62"
"66","27","83","77","62","66","68","84","89","25","67","69","81","54","73","79"
"4","1","1","11","23","1","1","1","24","1","1","1","1","1","1","20"
"26","27","40","18","60","40","29","34","39","30","26","33","28","1","24","34"
"62","38","68","71","64","62","36","42","64","36","62","67","33","35","65","74"
"59","46","63","70","66","43","60","59","61","60","44","68","63","43","69","67"
"48","28","30","31","43","64","46","50","20","45","33","27","48","35","43","48"
"48","22","41","54","46","53","9","26","52","10","48","48","12","18","36","37"
"70","44","57","69","76","73","65","34","65","35","67","55","41","36","77","38"
"70","71","67","35","29","91","33","38","41","32","92","43","66","30","94","83"
"91","31","66","81","65","85","82","86","87","36","77","81","75","30","88","84"
"56","37","56","40","41","59","57","59","39","43","62","42","39","39","36","65"
"9","79","4","35","69","7","2","10","19","11","55","21","2","3","7","1"
"48","37","23","50","49","45","34","41","39","36","39","35","30","39","43","45"
"57","41","61","53","55","61","41","42","55","43","57","36","44","43","54","60"
"73","48","57","47","55","66","44","42","55","53","59","45","46","5","88","59"
"33","13","29","32","16","36","29","16","30","23","36","27","25","17","21","29"
"80","77","28","56","30","75","30","24","32","84","76","67","28","21","72","81"
"33","1","37","21","36","49","1","1","40","1","35","24","1","29","16","41"
"1","100","1","1","1","1","1","1","1","1","1","1","1","1","1","1"
"66","32","22","68","60","38","33","22","38","34","57","18","33","41","68","63"
"42","40","60","57","43","44","40","9","34","29","43","46","44","44","58","65"
"38","33","31","33","32","36","27","29","44","30","35","26","24","30","56","54"
"39","47","33","37","43","41","37","42","41","44","40","41","48","40","43","44"
"74","43","64","66","68","57","42","47","64","47","75","56","43","45","56","58"
"44","1","1","23","36","49","22","1","44","1","65","21","22","1","1","46"
"67","1","58","61","22","56","14","1","62","1","38","55","25","1","18","58"
"0","0","0","0","0","","0","0","0","0","0","0","0","0","0","0"
"0","","0","0","0","0","0","0","0","0","0","0","0","0","0","0"
"0","0","0","0","0","0","0","","0","0","0","0","0","0","0","0"
"67","32","62","38","59","59","33","31","59","34","63","48","14","38","72","63"
"74","35","68","70","72","90","69","74","66","34","70","36","62","18","63","70"
"35","6","26","27","32","60","20","24","31","6","34","28","29","26","69","35"
"8","25","9","13","41","37","10","13","43","21","8","8","25","4","16","48"
"23","73","63","20","23","11","10","15","17","14","69","10","7","9","37","40"
"77","43","70","65","58","82","61","40","88","46","80","46","48","46","75","68"
"41","16","28","50","29","46","24","17","37","17","54","31","17","37","28","34"
"28","5","40","30","6","38","13","1","40","13","35","16","31","30","40","53"
"5","1","35","13","1","33","17","7","32","11","17","25","30","13","33","18"
"30","61","35","34","57","45","30","33","36","31","39","56","38","32","34","28"
"41","27","33","8","56","37","33","17","59","28","32","43","34","35","21","37"
"71","6","37","17","19","87","37","32","72","3","28","19","31","30","78","72"
"67","29","32","79","60","78","79","66","37","74","70","24","81","70","82","78"
"36","45","44","46","44","56","37","48","34","47","33","40","41","45","45","49"
"12","11","14","11","6","19","12","20","14","15","20","10","12","20","38","12"
"48","10","47","36","39","9","14","15","48","14","49","34","11","12","10","39"
"54","44","62","61","61","61","40","38","64","41","61","60","38","33","59","62"
"63","32","57","68","61","72","68","26","57","28","59","28","32","43","58","38"
"57","49","53","61","57","48","50","50","53","49","57","58","50","48","61","46"
"47","57","40","59","58","39","35","40","47","43","38","43","44","37","37","56"
"75","57","7","63","71","71","30","28","77","31","68","31","28","27","35","27"
"47","41","32","37","35","38","35","39","35","36","44","36","51","27","74","49"
"33","24","39","36","32","44","30","28","17","16","31","22","14","28","18","39"
"66","34","40","62","69","74","62","46","72","40","70","59","43","68","70","54"
"28","33","22","33","31","24","70","33","27","64","64","39","26","32","86","64"
"17","1","1","6","8","8","11","1","14","1","1","1","1","1","1","10"
"75","30","65","62","48","87","33","31","65","27","77","54","35","39","94","39"
"77","65","71","81","59","59","77","100","88","75","44","64","40","67","64","55"
"36","22","24","23","16","72","74","75","30","75","33","37","32","66","78","30"
"90","37","60","82","42","82","27","18","83","29","81","35","26","34","62","74"
"57","23","41","58","75","39","24","43","47","21","66","31","39","29","24","36"
"67","28","50","42","34","60","40","22","64","22","45","51","30","21","46","36"
"52","43","49","50","53","46","48","50","52","57","50","50","47","49","58","48"
"64","23","11","64","13","65","16","26","27","22","70","14","24","21","70","28"
"30","84","36","45","48","28","23","58","48","56","31","46","14","29","23","47"
"59","35","44","55","45","59","45","37","59","41","66","48","47","49","55","57"
"42","43","48","42","43","58","44","46","47","45","56","40","47","43","55","43"
"74","66","25","62","74","64","9","29","71","33","67","21","22","11","58","32"
"42","1","41","19","1","66","35","1","38","1","35","29","31","1","36","57"
"59","43","62","61","61","67","60","57","77","43","71","60","58","46","60","61"
"39","41","43","42","63","45","45","42","62","40","35","42","41","44","59","42"
"68","14","42","41","28","42","35","35","58","18","59","36","35","42","22","42"
"72","41","65","68","67","65","42","28","63","43","64","70","40","42","49","44"
"64","12","28","45","41","67","11","6","28","12","77","30","32","21","63","62"
"57","43","28","44","54","41","43","38","35","52","47","60","44","54","56","59"
"57","18","55","43","25","52","26","45","42","22","48","5","20","45","48","53"
"42","42","33","40","41","43","37","31","42","40","45","36","43","33","42","40"
"15","8","10","13","17","29","21","22","21","17","21","11","8","15","47","11"
"24","75","58","26","22","35","13","34","24","21","31","12","32","7","23","3"
"64","32","37","38","42","67","34","28","61","26","65","31","30","29","38","38"
"57","35","40","43","54","54","32","34","56","37","51","36","45","22","57","18"
"39","14","32","37","35","43","19","24","42","22","41","20","15","28","41","38"
"42","8","6","59","30","57","3","33","34","40","31","29","5","41","33","43"
"55","22","58","53","54","57","43","34","47","34","57","45","32","39","35","57"
"50","43","61","60","51","65","50","40","62","40","57","65","48","39","75","61"
"60","37","41","37","30","60","33","30","42","33","61","33","36","41","48","46"
"34","16","45","37","34","66","21","30","29","40","32","27","42","40","57","37"
"47","40","40","46","47","46","33","42","47","42","46","41","31","27","40","42"
"34","33","26","40","33","25","32","60","23","28","39","34","32","42","22","25"
"62","38","44","64","41","58","39","33","61","35","72","41","39","32","43","41"
"63","14","32","56","22","39","37","34","58","33","61","42","33","42","22","43"
"55","17","53","54","44","55","53","45","55","38","64","53","53","53","73","75"
"51","36","62","62","42","81","43","50","60","41","65","61","35","61","30","69"
"63","39","39","65","63","65","75","37","68","36","64","38","58","62","38","60"
"67","27","32","67","74","78","53","30","73","22","66","36","37","19","82","16"
"17","4","22","17","3","24","17","13","26","9","26","16","6","21","30","17"
"13","23","21","15","17","27","27","23","26","24","28","30","28","32","58","57"
"38","65","40","39","59","30","35","40","40","34","38","40","25","37","61","26"
"64","35","30","62","60","61","21","32","59","19","74","43","11","24","62","28"
"28","67","24","22","29","19","27","19","23","74","22","31","37","24","74","63"
"58","55","53","55","57","57","45","39","48","56","53","46","45","46","47","47"
"100","36","67","98","63","100","77","90","93","68","85","96","74","50","48","100"
"59","30","44","57","34","62","29","29","41","43","63","54","52","28","36","41"
"36","26","56","43","29","71","35","29","37","67","37","17","63","41","69","64"
"38","1","1","1","1","17","1","27","21","20","1","1","1","1","1","35"
"53","46","46","47","53","53","49","48","53","49","54","53","49","49","54","50"
"74","21","61","57","34","64","32","28","58","20","54","31","25","21","60","19"
"66","82","17","72","39","34","10","25","22","18","66","16","11","14","17","15"
"57","31","37","35","39","41","45","32","35","28","35","33","38","57","64","58"
"73","43","69","63","59","77","64","67","69","61","78","37","42","74","88","73"
"60","34","23","47","34","46","30","39","29","32","53","34","28","23","21","36"
"66","50","68","64","82","81","63","49","84","49","82","65","51","58","84","54"
"14","1","9","31","6","17","1","10","22","1","1","7","1","1","1","37"
"45","38","45","40","64","64","61","39","41","61","63","40","42","35","62","51"
"66","40","58","57","43","63","50","40","62","41","62","50","49","41","67","59"
"72","28","29","28","35","66","44","28","38","34","39","40","34","38","30","17"
"59","46","35","30","17","58","25","40","21","39","56","23","24","22","57","40"
"73","22","59","73","92","69","78","34","83","31","73","74","67","55","62","72"
"40","32","14","24","40","91","23","5","40","3","89","26","4","2","17","56"
"27","25","27","25","25","60","35","32","26","57","61","29","39","52","37","57"
"76","21","88","72","72","95","42","49","81","21","80","56","42","51","84","53"
"44","42","22","37","19","57","21","37","46","28","36","26","15","29","63","57"
"54","22","31","47","49","40","40","42","59","28","57","40","32","36","46","45"
"28","26","19","26","27","66","27","33","34","37","25","32","17","30","70","36"
"32","36","18","24","18","28","35","40","31","38","26","25","11","33","69","36"
"47","35","59","45","39","44","55","52","55","46","41","41","55","39","44","61"
"47","40","42","44","40","55","36","35","48","35","48","48","37","17","28","37"
"88","33","42","33","56","35","66","37","31","34","71","73","18","49","38","25"
"60","28","55","61","60","61","45","45","58","56","56","57","41","66","64","43"
"42","46","57","45","42","56","49","45","57","58","44","41","45","66","43","61"
"60","60","49","56","27","60","68","44","57","57","69","55","50","44","100","69"
"73","30","67","28","42","79","66","32","66","33","75","44","46","50","77","70"
"64","10","57","45","37","62","47","65","64","43","60","42","54","38","43","58"
"57","46","57","57","55","52","48","48","62","48","49","52","46","49","49","54"
"83","22","56","27","50","65","31","26","52","38","70","54","50","22","83","53"
"41","29","45","43","36","60","40","57","44","41","42","34","45","36","84","42"
"61","33","32","35","39","66","25","24","40","20","62","34","28","31","41","40"
"24","23","31","5","27","31","10","7","24","31","7","15","19","50","54","1"
"27","20","26","14","24","36","36","27","10","22","9","23","37","28","74","9"
"66","32","64","59","61","60","64","59","61","70","62","68","57","66","70","57"
"41","21","41","40","35","46","27","41","52","31","35","40","25","39","59","38"
"89","20","59","78","59","83","28","36","75","7","85","61","37","16","38","60"
"77","19","92","12","22","82","11","16","66","77","79","30","26","23","72","70"
"65","28","45","65","38","53","30","34","58","16","71","40","40","60","39","63"
"95","6","86","61","21","86","66","13","75","19","100","60","62","40","100","73"
"36","69","39","64","45","56","38","64","63","66","69","44","61","53","83","64"
